WWWWWWWWWWWWWWWWWWWWWWWWWWWWWWWWWW
W P                              W
W      Z       B                 W
W             CB                 W
W                                W
W                                W
W              B                 W
W                                W
W                                W
W                                W
W                                W
WWWWWWWWWWWWWWWWWWWWWWWWWWWWWWWWWW